#################
#               #
#               #
#               #
#               #
#               #
#               #
#               #
#  >            #
#               #
#               #
#               #
#               #
#               #
#               #
#               #
#################
