#################
#               #
#               #
#               #
#               #
#               #
#               #
#               #
#  >         o  #
#               #
#               #
#               #
#               #
#               #
#               #
#               #
#################